...#############
......#.....#..#
####..#..####..#
#........#.....#
####..####..#..#
#...........#..#
#..#..#..#..#..#
#..#..#..#..#..#
#..#######..#..#
#.....#.....#...
#############...
